########
#O    P#
#OOX  X#
#     X#
########
