########
#OXX  X#
#OO    #
#   P  #
########
