########
#O X  X#
#OOX   #
#  P   #
########
